28 27 28 27 28 27 28 28 28 27 28 28 28 28 28 27 28 28 28 28 27 28 28 28 28 28 28 28 28 28 28 27 28 28 27 28 28 28 27 28 28 28 28 28 27 28 28 27 28 28 
27 28 28 28 27 28 28 27 28 28 28 28 28 28 28 27 28 28 28 28 28 28 28 28 28 27 28 28 28 27 28 28 28 28 28 28 28 27 28 28 28 28 28 28 28 28 27 28 28 28 
28 28 22 15 15 15 15 15 15 15 15 15 15 15 15 15 15 15 15 15 15 15 15 15 15 15 15 15 15 15 15 15 15 15 15 15 15 15 15 15 15 15 15 15 15 15 13 28 28 28 
28 28 11 18 19 19 19 19 19 19 19 19 19 19 19 19 19 19 19 19 19 19 19 19 19 19 19 19 19 19 19 19 19 19 19 19 19 19 19 19 19 19 19 19 19 19 21 27 27 27 
27 28 11 18 19 19 19 19 19 19 19 19 19 19 19 19 19 19 19 19 19 19 19 19 19 19 19 19 19 19 19 19 19 19 19 19 19 19 19 19 19 19 19 19 19 19 21 28 28 28 
28 28 11 18 19 19 19 24 30 30 30 30 30 30 30 30 30 30 30 30 30 30 30 30 30 30 30 30 30 30 30 30 30 30 30 30 30 30 30 30 25 19 19 19 19 19 21 28 28 28 
28 27 11 19 19 19 19 7 31 31 31 31 31 31 31 31 31 31 31 31 31 31 31 31 31 31 31 31 31 31 31 31 31 31 31 31 31 31 31 31 12 19 19 19 19 19 21 28 28 28 
28 28 11 19 19 19 19 9 5 5 5 5 5 5 5 5 5 5 5 5 5 5 5 5 5 5 5 5 34 31 20 5 5 5 5 5 5 5 5 5 6 19 19 19 19 19 21 27 28 28 
27 28 11 19 19 19 19 19 19 19 19 19 19 19 19 19 19 19 19 19 19 19 19 19 19 19 19 19 7 31 12 19 19 19 19 19 19 19 19 19 19 19 19 19 19 19 21 28 28 28 
27 28 11 19 19 19 19 19 19 19 19 19 19 19 19 19 19 19 19 19 19 19 19 19 19 19 19 19 7 31 12 19 19 19 19 19 19 19 19 19 19 19 19 19 19 19 21 27 28 28 
28 28 17 3 3 3 3 3 3 3 3 3 3 3 3 3 3 3 3 3 3 1 19 19 19 19 19 19 7 31 12 19 19 19 19 19 19 19 19 19 19 19 19 19 19 19 21 28 27 28 
28 28 28 22 15 15 15 15 15 15 15 15 15 15 15 15 15 15 15 15 15 0 19 19 19 19 19 19 7 31 12 19 19 19 19 19 19 19 19 19 19 19 19 19 19 19 21 28 28 28 
28 28 28 11 19 19 19 19 19 19 19 19 19 19 19 19 19 19 19 18 19 19 19 19 19 23 19 19 7 31 12 19 19 19 23 19 19 19 19 23 19 19 19 19 19 19 21 28 28 28 
28 27 28 11 19 18 19 19 19 19 19 19 19 19 19 19 19 19 19 19 19 19 19 19 19 19 19 19 7 31 12 19 18 19 19 19 19 19 19 19 19 19 19 19 19 19 21 28 28 28 
28 28 27 11 19 18 19 19 23 19 19 19 19 19 19 19 19 18 19 33 19 19 18 19 19 19 19 18 7 31 12 19 33 19 19 19 19 19 19 19 19 24 30 25 19 19 21 28 27 28 
28 28 28 11 19 19 19 19 19 19 19 19 19 19 19 19 19 19 19 19 19 19 19 19 18 19 19 19 7 31 12 18 19 19 19 18 19 19 19 19 19 7 31 12 19 19 21 27 28 28 
28 27 28 11 19 19 19 19 19 19 19 19 19 24 30 30 30 30 30 30 30 30 30 30 30 30 30 30 29 31 12 19 19 19 19 18 23 19 19 19 19 7 31 12 19 19 21 28 28 28 
28 28 28 11 19 19 23 19 18 18 19 19 19 7 31 31 31 31 31 31 31 31 31 31 31 31 31 31 31 31 12 19 19 19 19 18 19 19 19 33 19 7 31 12 19 19 21 28 28 28 
28 28 27 11 19 19 18 19 23 19 19 19 19 9 5 34 31 20 5 5 5 5 5 5 5 5 5 5 34 31 12 19 19 19 19 19 19 19 19 19 19 7 31 12 19 19 21 28 27 28 
28 27 28 11 19 33 19 19 19 19 19 18 18 19 19 7 31 12 19 19 18 19 23 19 19 19 19 19 7 31 12 19 19 19 19 19 19 19 19 19 18 7 31 12 19 19 21 28 28 28 
27 28 28 11 19 19 19 18 19 19 18 19 19 18 19 7 31 12 19 23 19 19 19 19 19 19 23 19 7 31 12 18 19 19 18 19 19 19 19 19 19 7 31 12 19 19 21 27 28 28 
28 28 28 11 19 19 19 18 19 19 19 19 19 19 19 7 31 12 19 19 19 19 19 19 19 19 19 19 7 31 12 19 35 1 19 19 19 35 1 19 19 7 31 12 19 19 21 28 28 28 
28 27 28 11 19 19 19 19 19 19 19 19 19 18 19 7 31 12 19 19 35 3 3 3 3 3 1 19 7 31 12 19 21 11 19 19 19 21 11 19 19 7 31 12 19 19 21 28 28 28 
28 28 28 11 19 18 33 19 19 18 19 19 19 19 19 7 31 12 19 19 21 27 28 28 28 28 11 19 7 31 12 19 21 17 1 19 35 32 11 19 19 7 31 12 19 19 21 28 28 28 
28 28 27 11 19 19 19 18 19 18 19 19 18 19 19 7 31 12 19 19 21 28 10 28 27 28 11 19 7 31 12 19 21 22 0 19 14 13 11 19 19 7 31 12 19 19 21 28 28 28 
27 28 28 11 19 19 19 19 19 19 19 18 19 19 19 7 31 12 19 19 21 28 27 28 28 28 11 19 7 31 12 19 21 11 19 19 19 21 11 19 19 7 31 12 19 19 21 28 28 28 
28 27 28 17 3 3 3 3 3 3 3 1 19 19 19 7 31 12 19 19 14 15 15 15 13 27 11 19 7 31 12 19 21 11 19 19 19 21 11 19 19 7 31 12 19 19 21 28 28 28 
28 28 28 28 28 28 28 28 28 28 28 11 19 18 19 7 31 12 19 19 19 19 19 19 21 28 11 19 7 31 12 19 21 11 19 19 19 21 11 19 19 7 31 12 19 19 21 28 28 28 
28 28 28 27 28 28 28 28 27 28 28 11 18 19 19 7 31 12 19 23 19 19 19 19 21 27 11 19 7 31 12 19 21 17 3 3 3 32 11 19 19 7 31 12 19 19 21 27 28 28 
28 28 28 28 28 28 28 28 28 28 28 11 19 19 19 9 5 6 19 19 19 19 19 19 14 15 0 19 7 31 12 19 14 15 15 15 15 15 0 19 19 7 31 12 19 19 21 27 28 28 
28 28 28 28 28 28 28 28 28 28 28 11 19 18 19 19 19 19 33 19 19 19 19 19 19 19 19 19 7 31 12 19 19 19 19 19 19 19 19 23 19 7 31 12 19 19 21 28 28 28 
28 28 28 28 28 28 28 28 28 28 28 11 19 19 18 19 19 19 19 18 19 19 19 19 19 19 19 19 7 31 12 19 33 19 19 19 19 19 19 19 19 7 31 12 19 19 21 28 27 28 
28 28 28 28 28 28 28 27 28 28 28 11 19 19 23 19 19 19 19 19 33 19 18 19 19 19 19 19 7 31 12 19 19 19 23 19 19 19 19 19 19 7 31 12 19 19 21 28 28 28 
28 28 28 28 28 27 28 28 27 28 27 11 19 19 19 19 19 18 19 19 19 19 19 19 18 19 19 19 7 31 8 30 30 30 30 30 30 30 30 30 30 29 31 12 19 19 21 28 28 28 
28 28 28 28 28 28 28 28 28 28 28 11 19 19 19 19 18 18 19 19 19 19 19 19 19 19 19 19 7 31 31 31 31 31 31 31 31 31 31 31 31 31 31 12 19 19 21 28 28 28 
28 28 28 28 28 28 28 28 28 28 28 11 18 19 19 33 18 18 19 18 23 19 19 19 23 19 19 19 7 31 20 5 5 5 5 5 5 5 5 5 5 5 5 6 19 19 21 28 28 28 
28 28 28 28 28 27 28 28 28 28 28 11 19 18 19 18 19 19 19 19 19 19 19 19 19 19 18 19 7 31 12 19 19 19 19 19 19 19 19 19 19 19 19 19 19 19 21 28 28 28 
28 27 28 28 28 28 27 28 28 28 28 11 19 19 19 19 19 19 18 19 18 19 19 19 19 19 19 19 7 31 12 19 19 35 3 3 3 3 3 3 3 3 3 3 3 3 32 28 28 28 
28 28 28 28 28 28 28 28 28 28 28 11 19 19 19 19 19 18 19 19 19 19 18 19 18 19 19 19 7 31 12 19 19 14 15 15 15 15 15 15 15 15 15 15 15 15 13 28 28 28 
28 28 28 28 28 28 28 28 28 28 28 11 18 19 19 19 19 19 19 19 18 19 19 19 19 19 19 19 7 31 12 19 19 19 19 19 19 19 19 19 19 19 19 19 19 19 21 27 28 28 
28 28 27 28 28 28 28 28 28 28 28 11 19 19 19 19 19 24 30 30 30 30 30 30 30 30 30 30 29 31 8 30 30 30 25 18 19 33 18 19 19 19 18 33 19 19 21 28 27 28 
28 28 28 28 28 28 28 27 28 28 28 11 19 33 19 19 19 7 31 31 31 31 31 31 31 31 31 31 31 31 31 31 31 31 12 19 19 18 18 19 19 19 19 19 19 19 21 28 28 28 
28 28 27 28 28 28 28 28 28 28 28 11 19 19 19 19 19 9 5 5 5 5 5 5 5 5 5 5 5 5 5 5 5 5 6 19 19 19 19 19 19 19 19 19 19 18 21 28 28 28 
28 28 28 27 28 28 27 28 28 27 28 11 19 19 19 19 19 19 18 19 19 19 19 19 19 19 19 19 19 19 18 19 19 19 19 19 19 19 18 19 33 18 19 19 19 19 21 28 28 28 
28 28 28 28 28 27 28 28 28 28 28 11 19 19 19 19 19 18 19 19 19 18 18 18 19 18 19 19 19 19 19 18 19 19 19 19 19 19 19 19 19 19 19 18 19 19 21 28 28 28 
28 27 28 28 28 28 28 27 28 28 28 17 3 3 3 3 3 3 3 3 3 3 3 3 3 3 3 3 3 3 3 3 3 3 3 3 3 3 3 3 3 3 3 3 3 3 32 27 28 28 
28 28 28 28 28 28 28 28 28 28 28 28 28 28 28 28 28 28 28 28 28 28 28 28 28 28 28 28 28 28 28 28 28 28 28 28 28 28 28 28 28 28 28 28 28 28 28 28 28 28 
28 28 28 28 28 27 27 28 28 28 28 27 28 28 28 28 28 27 28 27 28 28 28 28 28 28 27 28 28 28 28 28 28 28 27 28 28 27 28 28 28 28 27 28 28 28 28 28 28 28 
28 28 28 28 28 28 28 28 28 28 27 28 28 28 28 28 28 28 27 28 28 28 27 28 28 28 28 28 28 28 28 28 28 28 28 28 27 28 28 28 28 27 28 28 28 28 28 27 28 28 
28 28 28 28 28 28 28 28 27 28 28 28 28 28 28 28 28 28 28 28 28 27 28 27 28 28 28 28 28 28 28 28 28 28 28 27 28 28 28 28 28 28 28 28 28 28 28 28 28 28 
